17
25
WWWWWWWWWWWWWWWWWWWWWWWWW
W     W O          W  E W
W P   W          O W    W
W     W      W     W    W
WWW WWW      W     WOOOOW
W            W     W    W
W        O   W     W    W
W     F      W     WF   W
W            W     W    W
WWWWWWWWWWWWWW     W  O W
W F             O  W    W
W     O            W    W
WWWWW   WWWWWWWWWWWW    W
W                  O    W
W         O           O W
W   O                   W
WWWWWWWWWWWWWWWWWWWWWWWWW
